##########             
########               
#######           
#######
####### k      ¬=======r ¬=r  =
#######====r                  #=^==)
#######                         |
#######                         |
#######          >  s         (===)
#######=rbbb¬r  ¬======r  ¬===#####)
####WWWWWWWWWWWWWWWWWWWWWWWW#########################################################################################################################