#######                
#######                
#######           
#######
#######        ¬=======r
#######===r
#######
#######           
#######          >            (===)
#######=rbbb¬r  ¬======r  ¬===#####)
####WWWWWWWWWWWWWWWWWWWWWWWW#########################################################################################################################